1111111111111111111111
100000C000000000000001
1000000000000P00000001
1000000000000000000001
100C000000000000000001
1111111111111111111111
